11111111111111     
1PCC00000000E1   
11111111111111 